Stage 1
#############
#########  ##
##Po       ##
#########  ##
#########   #
#O          #
#############
=
Stage 2
######
 #P   #
  # o  #
   #    #
    #   O#
     ######
=
Stage 3
#####
#P  ##
#Oo0 #
#  # #
#    #
######
=
Stage 4
######
#P   ##
# oo  #
# #O O#
#     #
#######
=
Stage 5
 #####
##O  ###
#  # oP#
#  # # #
# 0  oO#
#    ###
######